....x.......x..x..xxx
x..............x....x
.xx.......x...x..xxx.
.........x...........
....xxxxx...xxxx...x.
.......x....x.....xx.
...x......x..xxx..xx.
............x........
xxxxxx.x..xxxxx.x...x
.......xx...xx..xxx..
...x.xxx...xx.....xx.